11111111
10000001
1CCPE001
11111111